# Team map knowledge
# Legend: ? unknown, . explored, F fire, W water, H firefighter, T firetruck, C firecopter
# Bounds: x=0..3, y=0..18
   0 W . . .
   1 . . . .
   2 . . . .
   3 . . . .
   4 . . . .
   5 . . . .
   6 . . . .
   7 . . . .
   8 . . . .
   9 . . . .
  10 . . . .
  11 . . . .
  12 . . . .
  13 . . . .
  14 . . . .
  15 . . . .
  16 . . . .
  17 . . . .
  18 . . . ?
